######################################## #######################################
#                         # # # # # #           #       #   #                  #
#                         #     #                           #                  #
# # # # # # # #           #           # # # # # # # # # #   #                  #
#             #           #     #     #           #         #           # # #  #
#             #           #     #     #       #   #   # #   # # # # # #        #
#             #           #     #     #       #   #   # #   #         #   # #  #
#             #           #     #     # # # # #   #   # #   #         #   #    #
#             #           #     # # # #               # #   #         #   #    #
#             # # # # # # #                   # # # # # # # #         #   #    #
#                         # # # # # # # #                             #   #    #
#                         # # # # # # # #   # # # # # # # # # # # #   #   #    #
#      Final Level        #                 #                     #       #    #
#                         #     # # #   #   #                     # # # # # #  #
#                         #     #           #                                  #
############################ ##### # ### # ####################################
