######################################## #######################################
#                                             #         # # # # #              #
#                           # # # # #     #   #     #             #            #
#                             #     #     #   #     #       # #   #            #
#                             #     #     #   #     #   #   # #   #            #
#               # # # # # # # # #   #     #   # # # #   #   # #   #            #
#               #                   #     #   #         #   # #   #            #
#               #   # # # # # # #   #     #   #   # #   #                      #
#               #             #     #     #   #   #     # # # # #   # # # # # ##
#               #     # #     #     #     #                             #      #
#               #       #     #           # # # # # # # # # # # #       #      #
#               #       #     #     #     #   #                         #      #
#               # # # # #     #           #   #     #   # # # # # # #   #      #
#                             # # # # # # #   #     #             #            #
#                     #                       #     #       #           #      #
################ ############# ############# ########### ################### ###
