######################################## #######################################
#                         #                     #                              #
# # #   # # # # # #   #       # # # # # #       #                              #
#   #     #                   #         #       #                              #
#   #     #       # # # #   # # # # # # # # #   # # # # # #                    #
#   #     # # # # #                     #         #       #                    #
#   #                                             #       #                    #
#   #                                   #         #       #                    #
#   # # # # # # # #   # # # # # # # # # # # #     #       #                    #
#     #           #   #                     #     # # #   #                    #
#         #       #   #   #   #     #   #   #             #                    #
#     # # #   # #     #   #   #     #   #   # # # # #                          #
#     #                   #   #     #   #                 #                    #
#     # # # # # # #     #     #     #   # # # # #         #                    #
#               #       #       #   #           #         #                    #
## ########### ############# ####################### ####### ###################
